[console_scripts]
hms-aws-ecs=hms_utils.aws_ecs:main
hms-aws-env=hms_utils.aws_env:main
hms-aws-env-hidden=hms_utils.aws_env:main
hms-config=hms_utils.config.config_cli:main
hms-config-export=hms_utils.config.config_cli:main_show_script_path
hms-config-exports=hms_utils.config.config_cli:main_show_script_path
hms-decrypt=hms_utils.cli.crypt_cli:main_decrypt
hms-encrypt=hms_utils.cli.crypt_cli:main_encrypt
hms-portal-add-consortia-to-items=hms_utils.portal.oneoff.portal_add_consortia_to_items:main
hms-portal-errors=hms_utils.portal.portal_validation_errors:main
hms-portal-files=hms_utils.portal.portal_files:main
hms-portal-generate-access-key=hms_utils.portal.portal_generate_access_key:main
hms-portal-indexing-status=hms_utils.portal.indexing_status:main
hms-portal-item-conflicts=hms_utils.portal.portal_item_conflicts:main
hms-portal-items-without-consortia=hms_utils.portal.oneoff.portal_items_without_consortia:main
hms-portal-permissions=hms_utils.portal.portal_permissions:main
hms-portal-randomize-md5sum-values=hms_utils.portal.oneoff.randomize_md5sum_values:main
hms-portal-read=hms_utils.portal.portal_read:main
hms-portal-reindex=hms_utils.portal.portal_reindex_items:main
hms-portal-simple-update=hms_utils.portal.portal_simple_update:main
hms-portal-update=hms_utils.portal.update_portal_object:main
hms-portal-user-update=hms_utils.portal.portal_user_update:main
hms-portal-users=hms_utils.portal.portal_users:main
hms-portal-view=hms_utils.portal.view_portal_object:main
hms-portal-write=hms_utils.portal.portal_write:main
hms-portals=hms_utils.portal.portal_envs:main
hmx-config=hms_utils.hms_config:main
hmx-config-export=hms_utils.hms_config:main_show_script_path
hmx-config-exports=hms_utils.hms_config:main_show_script_path
hmx-config-script=hms_utils.hms_config:main_show_script_path
publish-to-pypi=dcicutils.scripts.publish_to_pypi:main

